[JobPK]
20110922;A0001;5;EXIT
[Barcode]
PSA11I0420001
PSA11I0420002
PSA11I0420003
PSA11I0420004
PSA11I0420005

